./img/BlueTile.png
1,0,6,1,1
1,1,6,1,1
1,2,6,1,1
1,3,6,1,1
1,4,6,1,1
1,5,6,1,1
1,6,6,1,1
1,7,6,1,1
1,8,6,1,1
1,9,6,1,1
1,10,6,1,1
1,11,6,1,1
2,0,1,1,0
2,1,1,1,0
2,2,1,1,0
2,3,1,1,0
2,4,1,1,0
2,5,1,1,0
2,6,1,1,0
2,7,1,1,0
2,8,1,1,0
2,9,1,1,0
2,10,1,1,0
2,11,1,1,0
3,0,2,1,0
3,1,2,1,0
3,2,2,1,0
3,3,2,1,0
3,4,2,1,0
3,5,2,1,0
3,6,2,1,0
3,7,2,1,0
3,8,2,1,0
3,9,2,1,0
3,10,2,1,0
3,11,2,1,0
4,0,0,1,0
4,1,0,1,0
4,2,0,1,0
4,3,0,1,0
4,4,0,1,0
4,5,0,1,0
4,6,0,1,0
4,7,0,1,0
4,8,0,1,0
4,9,0,1,0
4,10,0,1,0
4,11,0,1,0
5,0,4,1,0
5,1,4,1,0
5,2,4,1,0
5,3,4,1,0
5,4,4,1,0
5,5,4,1,0
5,6,4,1,0
5,7,4,1,0
5,8,4,1,0
5,9,4,1,0
5,10,4,1,0
5,11,4,1,0
6,0,5,1,0
6,1,5,1,0
6,2,5,1,0
6,3,5,1,0
6,4,5,1,0
6,5,5,1,0
6,6,5,1,0
6,7,5,1,0
6,8,5,1,0
6,9,5,1,0
6,10,5,1,0
6,11,5,1,0
7,0,3,1,0
7,1,3,1,0
7,2,3,1,0
7,3,3,1,0
7,4,3,1,0
7,5,3,1,0
7,6,3,1,0
7,7,3,1,0
7,8,3,1,0
7,9,3,1,0
7,10,3,1,0
7,11,3,1,0
